#######
#S....#
#.##..#
#...#.#
#..##G#
#######
